SO  ../textures/AnyConv.com__bluestone.xpm
NO ../textures/Nyassine.xpm
WE ../textures/Wyassine.xpm
EA ../textures/Wyassine.xpm

C 240,26,70
F 230,200,130

111111
1W00010
1111 1
