SO  ../textures/Syasine.xpm
NO ../textures/Nyassine.xpm
WE ../textures/Wyassine.xpm
EA ../textures/Wyassine.xpm

F 56,165,10
C 56,165,250


1111111111111111111111111111111111111111111111111111111111111111111111111111111111111
1000000000000000000000000000011111111111111111111111111111111111111111111111111
100111100011110001111000111101111111111111111111111111111111111111111111111
100100100010010001001000100101
10011110001111000111100011110
100000000000E00000000000000001111111111111111111111111111111111111111111111
101111101011111010111101011101
100000001000000010000001000001
100111101000111010001110100101
100100001000100010001000100101
100111101011110010111101011101
100000000000000000000000000001
101111101011111010111101011101
100000001000000010000001000001
100111101000111010001110100101
100100001000100010001000100101
100111101011110010111101011101
100000000000000000000000000001
101111101011111010111101011101
100000001000000010000001000001
100111101000111010001110100101
100100001000100010001000100101
100111101011110010111101011101
100000000000000000000000000001
101111101011111010111101011101
100000001000000010000001000111
100111101000111010001110100101
100100001000100010001000100101
100111101011110010111101011101
111111111111111111111111111111
