F 1,251,0
C 2,5,100
SO  ../textures/Syasine.xpm
NO ../textures/Nyassine.xpm
WE ../txtures/Wyassine.xpm
EA ../textures/Wyassine.xpm

11111111111                   1111111111111
1000000001111111111         1111000000N111111111
1111111111111111         	    111 1111111111
