SO	textures/AnyConv.com__redbrick.xpm
NO	textures/AnyConv.com__eagle.xpm
WE	textures/AnyConv.com__greystone.xpm
EA	textures/AnyConv.com__wood.xpm
F	230,200,130
C	240,26,70


11111111111111111111111111111111      11111111
1S000000000000000000000000000111      11111111
100111100011110001111000111101     1111111111
100100100010010001001000100101
100111100011110001111000111101
100000000000100000000000000001
101111101011111010111101011101
100000001000000010000001000001
100111101000111010001110100101
100100001000100010001000100101
100111101011110010111101011101
100000000000000000000000000001
101111101011111010111101011101
100000001000000010000001000001
100111101000111010001110100101              111111
100100001000100010001000100101
100111101011110010111101011101
100000000000000000000000000001
101111101011111010111101011101
100000001000000010000001000001
100111101000111010001110100101
100100001000100010001000100101
100111101011110010111101011101
100000000000000000000000000001
101111101011111010111101011101
100001111100000010000001000111
100111   100111010001110100101
100101   100100010001000100101
100111   111110010111101011101
111111   111111111111111111111
