SO  ../textures/Syasine.xpm
NO ../textures/Nyassine.xpm
WE ../textures/Wyassine.xpm
EA ../textures/Wyassine.xpm

F 56,165,10
C 56,165,250


1111111
1000001
100N001
1000001
1111111
