SO  ../textures/Syasine.xpm
NO ../textures/Nyassine.xpm
WE ../textures/Wyassine.xpm
EA ../textures/Wyassine.xpm

F 56,165,10
C 56,165,250


11111111111111111111111111111111      11111111111111111111111111111111111111111111111111111
1S000000000000000000000000000111      11111111111111111111111111111111111111111111111
1001111000111100011110001111011     11111111111111111111111111111111111111111111
100100100010010001001000100101
100111100011110001111000111101
100000000000100000000000000001
101111101011111010111101011101
100000001000000010000001000001
100111101000111010001110100101
100100001000100010001000100101
100111101011110010111101011101
100000000000000000000000000001
101111101011111010111101011101
100000001000000010000001000001
100111101000111010001110100101              111111
100100001000100010001000100101
100111101011110010111101011101
100000000000000000000000000001
101111101011111010111101011101
100000001000000010000001000001
100111101000111010001110100101
100100001000100010001000100101
100111101011110010111101011101
100000000000000000000000000001
101111101011111010111101011101
100000001000000010000001000111
100111101000111010001110100101
100100001000100010001000100101
100111101011110010111101011101
111111111111111111111111111111
